XXXXXXXXXX
X........X
X..@.....X
X........X
X........X
E........X
XXXXXXXXXX