XXXXXXXXXXXXXXX
X.............X
X.............X
X......@......X
X.............X
X.............X
X.............X
E.............X
XXXXXXXXXXXXXXX