XXXXXXXXXXXXXXXXXXXX
X..................X
X..................X
X..................X
X.........@........X
X..................X
X..................X
X..................X
X..................X
X..................X
E..................X
XXXXXXXXXXXXXXXXXXXX